111111111111111111111
100000000000000000001
101111111010111111101
101111*00010000111101
101111011010110111101
1e00000000000000000e1
101111111010111111101
100000000000000000001
101111011010110111101
101111000010000111101
101111111010111111101
1000000000000000000p1
111111111111111111111