1111111111111111111111111
1e000000000000t0000000001
1010111110101010111110101
100000000d10001*000000001
10111111111010111111111t1
1000000000001000000000001
1010101010101010101010101
1010101010101010101010101
1010101010101010101010101
1e000000000000000000000p1
1111111111111111111111111